1111111111111111111111111111111111111111
1P00000000000000000000000000000000000001
1000000000000000000000000000000000000001
1000000000000000000000000000000000000001
1001111000010000111100000010000100010001
1010000000000000100100000000000100010001
1010000000111000100100000111000100010001
1001110000000000111100000000000111110001
1000001001000100100010001000100100010001
1000001000000000100000000000000100010001
1011110010000010100001010000010100010001
1000000000000000000000000000000000000001
1000000000000000000000000000000000000001
10000000000000000CC0CC000000000000000001
1000000000000000C00C00C00000000000000001
10000000000000000C000C000000000000000001
100000000000000000C0C0000000000000000001
1000000000000000000C00000000000000000001
1000000000000000000000000000000000000001
10000000000000000000000000000000000000E1
1111111111111111111111111111111111111111